0017 0019 0004 0064 0001 0001 0065 0001 0001 0001 0003 0017 0017 0017 0017 0017
0017 0019 0017 0016 0017 0017 0019 0017 0123 0125 0019 0017 0017 0017 0017 0017
0000 0035 0017 0032 0001 0001 0035 0017 0155 0157 0019 0017 0017 0017 0017 0017
0016 0017 0017 0017 0017 0017 0017 0017 0069 0069 0048 0001 0001 0001 0001 0003
0016 0017 0017 0017 0017 0017 0017 0017 0069 0069 0017 0017 0017 0089 0089 0019
0016 0017 0018 0082 0001 0001 0001 0065 0001 0001 0001 0003 0090 0000 0001 0035
0016 0017 0017 0017 0017 0017 0020 0019 0017 0017 0017 0048 0001 0049 0017 0017
0016 0017 0000 0001 0001 0001 0001 0035 0017 0017 0017 0017 0017 0017 0017 0017
0016 0017 0032 0001 0001 0001 0001 0001 0001 0001 0001 0001 0001 0001 0001 0003
0016 0017 0017 0017 0017 0017 0017 0017 0017 0017 0017 0017 0017 0017 0017 0019
0032 0001 0001 0003 0090 0017 0017 0017 0017 0017 0017 0017 0089 0089 0089 0019
0017 0017 0017 0048 0001 0001 0001 0036 0001 0001 0001 0001 0001 0001 0001 0035
